11111111111111111111111111111111111111111111111111111111111
10000000000000000000000000000000000000000000000000000000001
10000000000000000000000000000000000000000000000000000000001
10000000000000000000000000000000000000000000000000000000001
10000000000000000000000000000000000000000000000000000000001
10000000000000000000000000000000000000000000000000000000001
10000000000000000000000000000000000000000000000000000000001
10000000000000000000000000000000000000000000000000000000001
10000000000000000000000000000010000000000000000000000000001
10000000000000000000000000000010000000000000000000000000001
10000000000000000000000000000010000000000000000000000000001
10000000000000000000000000000010000000000000000000000000001
10000000000000000000000000000010000000000000001000000000001
10000000000000000000000000000010000000000000001000000000001
10000000000000000000000000000010000000000000001000000000001
10000000000000000000000000000000000000000000001000000000001
10000000000000000000000000000000000000000000011110000000001
10000000000000000000000000000000000000000000000000000000001
10000000000000000000000000000000000000000000000000000000001
100000000000000000000000000000P0000000000000000000000000001
10000000000001111111100000000000000000000000000000000000001
10000000000000000000000000000000000000000000000000000000001
10000000000000000000000000000C00000000000000000000000000001
10000000000000000000000000000000000000000000000000000000001
10000000000000000000000000000000E00000000000000000000000001
10000000000000000000000000000000000000000000000000000000001
10000000000000000000000000000000000000000000000000000000001
10000000000000000000000000000000000000000000000001000000001
10000000000000000000000000000000000000000000000001000000001
10000000000000000000000000000000000000000000000001000000001
10000000000000000000000000000000000000000000000001000000001
10000000000000000000000000000011111111111111111111000000001
10000000000000000000000000000000000000000000000000000000001
10000000000000000000000000000000000000000000000000000000001
10000000000000000000000000000000000000000000000000000000001
10000000000000000000000000000000000000000000000000000000001
10000000000000000000000000000000000000000000000000000000001
10000000000000000000000000000000000000000000000000000000001
11111111111111111111111111111111111111111111111111111111111
