111111111111111111111111111111111111111111111111111111111111111111111111111111111111111
100C0C00000000000000000000000000000000000000000000000000000000000000000000000000000CPE1
111111111111111111111111111111111111111111111111111111111111111111111111111111111111111
