111111111111111111
1E000000CC00000001
10000000CC00000001
1000000000000000P1
111111111111111111
