111111111111111111111111111111111111111111
111111111111111111111111111111111111111111
111100000000000000000P00000000000000001111
111000000000000000000000011110000000000111
11000000000000011C000000110011000000000011
11000C0000000011CC0000001CCCC1100000000011
11000C000000011CCC00000000CCC1100000000011
11000C00000011CC110000000000110000C0000011
11000000000111111111000000011000000C000011
110000000000000011000000001100000000C00011
110000000000000011000000111111111000000011
11100000000CCCCCC0000E00000000CCCCCCC00111
11110000000000CCCCC000000000CCCCC000001111
111111111111111111111111111111111111111111
111111111111111111111111111111111111111111
