11111
10P01
11111
1E0C1
11111
