111111111
100000001
1PEC00001
1111111111
