111111111111111111111111111111
100000000000000000001111111111
10P00000000001100000000000C111
100111000000001000000000000111
10001100000000100000000C000001
1000000000110000000000C000C001
10000001111100C001100000000001
100010000000110000000001000C01
11001000000000000000E001000001
1111100C0001111111110011C11101
111111111111111111111111111111
