111111111
100000001
1PEC00001
11111111
